病患bh : 病患
慈善家csj : “慈善家”
大副df : 大副
飞行家fxj : 飞行家
古董商gds : 古董商
画家hj : 画家
击球手jqs : 击球手
机械师jxs' : 机械师
祭司js : 祭司
教授js : 教授
记者jz : 记者
空军kj : 空军
哭泣小丑kqxc : 哭泣小丑
昆虫学者kcxz : 昆虫学者
勘探员kty : 勘探员
拉拉队员lldy : 拉拉队员
律师ls : 律师
盲女mn : 盲女
冒险家mxj : 冒险家
魔术师mss : 魔术师
牛仔nz : 牛仔
前锋qf : 前锋
囚徒qt : “囚徒”
入殓师rls : 入殓师
守墓人smr : 守墓人
调酒师tjs : 调酒师
调香师txs : 调香师
玩具商wjs : 玩具商
舞女wn : 舞女
先知xz : 先知
小女孩xnh : “小女孩”
小说家xsj : 小说家
心理学家xlxj : “心理学家”
幸运儿xye : 幸运儿
野人yr : 野人
医生ys : 医生
佣兵yb : 佣兵
邮差yc : 邮差
园丁yd : 园丁
杂技演员zjyy : 杂技演员
作曲家zqj : 作曲家
咒术师zss : 咒术师